10.ox
.....oo...
.oo.oo....
.....oooo.
oo....oo.o
........o.
....oo...o
ooooo.o...
..o....o..
o.o.o.....
.oo.oo..o.
